21 21 3 10 14 10 7 10 o a
---------------------
-+++++++++-+++++++++-
-*---+---+-+---+---*-
=+++++++++++++++++++=
---+------+------+---
//-+-++-+++++-++-+-//
---+++----+----+++---
-+++-++++-+-++++-+++-
-+---+--+-+-+--+---+-
-+++++--+-+-+--+++++-
-----+-///////-+-----
-----+-/--/--/-+-----
-++++++/-///-/++++++-
-----+-/-----/-+-----
-----+-///////-+-----
-+++++--+---+--+++++-
-+---+++++-+++++---+-
-++-++---+++---+++++-
----+-----+-----+----
=+++++++++++++++++++=
---------------------