21 21 3 10 19 10 7 10 o a
---------------------
=+++++++++++++++++++=
---+-+----+----+-+---
//-+-+++++++++++-+-//
---+-+----+----+-+---
-+++-++++-+-++++-+++-
-+------+-+-+------+-
-+++--++++/++++--+++-
-+-++++-+-+-+-++++++-
-+----+-+-+-+-++++++-
-++++++-+-+-+-++++++-
---+----+++++----+---
---+++--+-+-+--+++---
-+++-++++-+-++++-+++-
-+-----+--+--+-----+-
-+++++++--+--+++++++-
---+---+--+--+---+---
//-+++-+++++++-+++-//
---+-+-+--/--+-+-+---
=+++++++-///-+++++++=
---------------------