21 21 15 10 9 10 11 10 c s
---------------------
-+++++++++-+++++++++-
-*---+---+-+---+---*-
-+++++++++++++++++++-
-+---+-+-----+-+---+-
-+++++-+++-+++-+++++-
-----+---+-+---+-----
////-+-///////-+-////
-----+-/--/--/-+-----
=++++++/-///-/++++++=
-----+-/-----/-+-----
////-+-///////-+-////
-----+-+-----+-+-----
-+++++++++-+++++++++-
-+---+---+-+---+---+-
-+++-+++++++++++-+++-
---+-+-+-----+-+-+---
-+++++-+++-+++-+++++-
-*-------+-+-------*-
-+++++++++++++++++++-
---------------------